w w S w w w w w w w w w w w w w w w 
 w B . B B B B B B B B B B B B B B w
w B . B B B B . . . . . . . . . B w 
 w B . B B B . B B B B B B B B . B w
w B B . B B . B B B B B l l B . B w
 w B B . . . B B B . . B B B . B B w
w B B B B B B B B . B . . . . B B w
 w B . . B B B B B . B B B m m m m w
w B . B . . . . . . B B B m M M m w
 w B . B B B B B B B s s m M L M m w 
w w w E w w w w w w s s s m M M m w
 w w w w w w w w w w s s s m m m w w
w w w w w w w w w w w w w w w w w w
 w w w w w w w w w w w w w w w w w w