x x S x x x x x x x x x x x x x x x 
 x B . B B B B B B B B B B B B B B x
x B . B B B B . . . . . . . . . B x 
 x B . B B B . B B B B B B B B . B x
x B B . B B . B B B B B B B B . B x
 x B B . . . B B B . . B B B . B B x
x B B B B B B B B . B . . . . B B x
 x B . . B B B B B . B B B B B B B x
x B . B . . . . . . B B B B B B B x
 x B . B B B B B B B B B B B B B B x 
x x x E x x x x x x x x x x x x x x